##################
#           o    #
#   A      @     #
#                #
##################